aac	audio/aac
css	text/css
csv	text/csv
gif	image/gif
htm	text/html
html	text/html
ico	image/x-icon
jpeg	image/jpeg
jpg	image/jpeg
json	application/json
mp3	audio/mpeg
oga	audio/ogg
ogv	video/ogg
pdf	application/pdf
png	image/png
sql	text/plain
svg	image/svg+xml
txt	text/plain
weba	audio/webm
webm	video/webm
xhtml	application/xhtml+xml
xml	application/xml